regardless : Malgré tout
To provide : fournir
Therefore : Par conséquent 
Hues : teinte
Shades : nuances
Perhaps : peut être
acknowledged : Reconnu
providing that : À condition que
run out of : manquer de 
take legal action : Intenter une action en justice
Work out : trouver, élaborer ou résoudre
Impress : impressionner 
Capacity : capacité (stockage)
Ability : capacité (skill d’une personne)
actually : en fait
Spare : supplémentaire / prêter / donner 
Quiet : tranquille
Praise : éloge
Lie : mensonge
Lay : allonger
effective : efficace (résultat)
Efficient : efficace (rapide)
involve : impliquer
Evolve : évoluer 
released :libérer 
convenience : avantage 
definitely : sans aucun doute
hopefully : Avec un peu de chance
A unique : un unique (non “an” unique)
practitioners : Praticiens
thoroughly : a fond 
apprentice : apprenti
alterations : modifications
award : prix
forward : en avant
to point out : Pour souligner 
To stir : remuer 
To slice : Trancher
To dice : coupé en dés
To chop : Hacher 
Dairy : laiterie
Some soap : Un peu de savon
To flush : Pour rincer
A chest of drawers : Une commode
drawers : Tiroirs 
To nap : siéster 
A wardrobe : Une armoire
Some cutlery : Quelques couverts
A kettle : une bouilloire 
Shelves : étagères
A rug : tapis  (petit)
An armchair : Un fauteuil
A cottage : un chalet 
A landlord / A landlady : propriétaire
A block of flats : Un bloc d'appartements
roadwork : travaux (pour les routes)
Used to : habitude dans le passé
Amount : montant (uncountable)
put down : Poser quelque chose
Enjoy : apprécier 
exhibit : Exposer
keynote : Thème principal
expectations : Attentes
remain : rester
boundaries : limites
Settle : regler (conflit)/s'installer
Lively : vif , animé
Kind : genre
A baker : Un boulanger
A butcher : Un boucher
An intern : un stagiaire 
foreman : contremaitre
The mining industry : L'industrie minière
A light industry : Une industrie légère
The hospitality industry : L'industrie hôtelière
To do casual work : Pour faire du travail occasionnel
To get fired : Pour se faire virer
To be made redundant : pour etre licencier (raisons économiques)
unemployed : au chômage 
Personal belongings : effet personnel
Wish : souhait + to
Close collaboration : collaboration étroite
Premises : locaux
Instead of : au lieu de
Unforeseen : non prévue
Call off : annuler 
Regarding : concernant 
Almost : presque 
Reach : atteindre
Willing : prêt 
Applicants : candidat
To be on time : être a l’heure
Wonderful : merveilleux 
Succed : réussir + in 
Advertising agency : agence de publicité
Otherwise : sinon , autrement
Label : étiquette
Famous : célèbre
Brands : marque
Set up : s’installer
Short term : court terme 
Sold out : épuiser (+of si équipement/objet)
Sued for : poursuivre en justice
Pursued : poursuivre / suivre
Clock in : pointer
To have lunch : déjeuner
Stressed out : stressé
Churches : église
Plenty : beaucoup / plus qu’assez 
First hand : experience / connaissance directe
Helpful : utile
Into : dans (verbe d’action)
Spend : dépenser
Valuables : objet de valeur 
Regardless : Malgré tout
Handle : poigné / gérer, faire face
Appliances : appareils électroménagers
Beyond : au dela
Head : en avant 
Unexpected : inattendu
Rising : hausse
Falling : baisse
Withdraw : retirer 
Grants : subvention
Patents : brever
Second hand : seconde main 
Appointed : Nommé
Money laundering : blanchir l’argent
Look forward to : attendre avec impatience 
Remote : distant
King regards : cordialement
Timetable : calendrier
Timeline : chronologie
Several : plusieurs 
Suitable : approprié
Libelous claim : revendication calomnieuse 
Keen : passionnée
Marks : marques (abimer)
Scratches : rayures
Thought : à travers
Get along : s’entendre (bonne relation)
Gather : rassembler 
Together : ensemble 
Weary : fatigué
Bet : pari
Proxy : mandataire
Shareholders :actionnaires 
Amendment : modifications
Foster : favoriser / adopter
Fine  : amende 
Unless : à moin que 
Out performing : surperformant
Bid : offre
Aloud : à haute voix
Shortlisted : présélectionné
Fare : tarification (pour service de transport) 
Assets : actifs
Ensurance : assurance (état d’esprit)
Insurance : assurance (couverture financière)
Aware : conscient
Sensitivity : sensibilité
Daunting : intimidant
Clasp : serré / saisir
Annoyed : agacé
Compréhensive : comprendre (inclure)
Demand : exiger
Postponed : reporté
Carry out : mener a bien
Suburds : banlieue 
Range : gamme / éventail 
Pivotal role : role centrale
Economical : économique (resource)
Economics : économie 
Still : encore 
Waste : gaspillage
Unlikely : peu probable
Notice période : période de préavis
Tenants : locataire
Own : posséder 
Typically : comme a son habitude
Bikes lanes : pistes cyclable 
Grow : grandir
Heavy : lourd
Overweight : obese
Dismissal : licenciement
Resignation : démission
Too late : trop tard
Seek : chercher
Noisy : bruyant
Rather :plutôt 
Supplier : fournisseur
Loan : un prêt
Terms and conditions : conditions generals
Siblings : frères et soeurs
Issued : publier
Out sourcing : externalization
Behind : derrière
Behind schedule : en retard
Vacancy : poste vacant 
Disclosure : révélation
Endeavors : efforts
Slight : léger
Enhanced : améliorer
Advice : conseil
Rewarding : gratifiant 
In the meantime : en attendant
Garbage : ordure
Fill in : remplir
Contest : concours / tournoi
String : corde
Quartet : quatuor 
Runner up : deuxième / vice champion
Billboard : panneau d’affichage
Wires : file de fer / file électrique
Dial tone : tonalité
Proven : éprouvé
Struggle : lutte
Strike : grève
Workforce : main d’oeuvre
Rewind : rembobiner
Stormy : orageux 
Until : jusqu’à
Overwhelmingly / de manière écrasante
Fundraising : collecte de fond 
Backdrop : toile de fond 
Wear : porter
Concerns : préoccupations
Number : Nombre (comptable)
Filing : classement
Out standing : en cours 
To forward : transferer
To back up : sauvegarder
A bookmarker : un signet
To spell : épeler 
To guess : deviner
Produce : produire
Behalf of : au nom de
Write off : faire passer au compte de perte de profit
Unfit : inapte
Besides : ailleurs 
Helpless : impuissant
Purpose : but
Tenancy : location
Thrown : jeter
Stolen : voler
Mind : esprit
Fair : justice
Crane : grue
Threat : menace
To enroll : s’inscrire
To dispute : contester
Layoff : licenciement
Workload : charge de travel
To inquire : se renseigner
Step down : retirer
Areas : domaines
A line with : conformément à
Candid : franc
Frightened : effrayer
Flaws : default
Insofar : dans la mesure 
Whereas : alors que 
Energie efficience : économie d’énergie
Proud : fière
Entrance : entrée (physiquement) 
Greet : accueillir
commute : trajet maison-travail
evening : soiree
To eat out : manger au resto
To entertain : divertir
To go out : Pour sortir
Some savings : quelques économies
To volunteer : se porter volontaire
To stay in : Pour rester dans
A temp : un intérimaire
The stationery : la papeterie
To go bankrupt : faire faillite
To manufacture : fabriquer 
A plant : une usine
A subsidiary : une filiale 
A corporation : une société
A sweatshop : endroit où on exploite la main d’œuvre
Un shift : un changement
The raw materials : Les matières premières
A mill : un moulin 
Automation : automatisation
Wheter … or : si 
to be summoned for : Être convoqué pour
To keep going : Pour continuer
seem : sembler / avoir l’air
Insofar : dans une telle mesure
breakdown : panne
motorway : autoroute
journey : voyage
to file for bankruptcy : Déclarer faillite
headache : mal de tete 
Content : contenu
Lease : bail
Cease : cesser
narrowed : Rétréci
additionally : En outre (fin de phrase)
Promptly : rapidement
Fortitude : courage apres douleur
Bustling : Animé
Avoid : éviter
Adverse : Défavorable
withholding : Retenue 
go through : Passer par
amenities : aménagements
enlightening : instructifs
To stretch : s’étirer
Hiking : randonné
A drum : batterie (instrument)
the till : La caisse
a fitting room : Une cabine d’essayage
court (sport) : terrain parquet (basket)
pitch : terrain synthétique / vert (foot)
Ethos : philosophie
Widely : Largement
Enlarge : agrandir
Glad : content
Null and void : sans valeur 
Mind : avis
Timely : ponctuelle
Address : s’occuper de
Delve into : fouiller dans
previously : auparavant
overcrowded : bondé/ surpeuplé (taille raisonnable)
Sticky : collant
Likely : probable 
an allowance : une allocation
bestseller : meilleure vente
A novel : un roman
publisher : Editeur
Skim through : Survoler
lend : prêter
some ink : De l’encre
Some clay : de l’argile 
Quiet : tranquille
Entitle : donner un titre a 
Boring : ennuyeux
Halted : arrêter
let someone know : faire savoir a quelqu’un
Snag : problèmes, pépin
Pride : fierté
Lonely : solitaire
Consists of : se compose de 
Neither... nor… : ni ….. ni
by the time : Au moment où
Quite : tout à fait
Away : extérieur
numerous : nombreux
Smooth : lisse
cutting-edge : de pointe
Gloves : gants
a hat : un chapeau
a ring : une bague
A skirt : une jupe
A jumper : un pull
A tie : une cravate 
A belt : une ceinture 
Slim : une mince
handsome : beau
clever : intelligent 
mean : méchant
Lazy : Paresseux
Kind : gentil 
an aunt : ta tante
a close friend : ami proche 
teenager : Un adolescent
to crawl : ramper
a toddler : un enfant de bas age 
retirement : une retraite
Complain : se plaindre
Workdays : jours ouvrable
Hang : accrocher
Careless : insouciante
Crying : pleurer
To lift : soulever
Straight : droit 
To run into someone : Rencontrer quelqu’un accidentellement 
shame : dommage
exhausting : épuisant
Guilty : coupable
Handling : gérer
Driveway : Dans l'allée
Melted : fondue 
The tow truck : La dépanneuse
Stuck : coincé
In the ditch : Dans le fossé
Collapse : s’effondrer
Relevant : pertinent
thought-provoking : Qui fait réfléchir
fireworks : feu d’artifice
aisle : allée
unruly : Indiscipliné
keychain : porte clé
Sailling : voile , naviguer
Crowd : foule
Shrine : Lieu de pèlerinage
breathing : Respiration 
Shore : rivage
the diver : le plongeur
commitment : engagement
complaining : Se plaindre
Then : alors / puis
Sunburn : coup de soleil
Shuttle : navette 
Caseload : charge de travail
Dizzy : étourdi
Hurry up : Depeche toi
Enough : assez
Weakness : Faiblesse
Rest : repos
Crowds : Foules
A realtor : agent immobilier
quotation : un devis 
windy : venteux
abroad : a l’étranger
A flat : un appartement
it is what it is : C'est la situation et elle doit être acceptée
to look after : s’occuper
Away : a l’extérieur
A band : group
The canned goods : Les conserves
Contentious : Controversé
Fail + to : Échouer
raw : cru
elsewhere : ailleurs
Cab : taxi
Perks : Avantage
Compliant : conforme
painkillers : analgiques
Incurred :encouru
lawnmower : Tondeuse (à gazon)
his shoulder : Son épaule
soaking up : S’imprégner
lit up : illuminé
A stroll : Une promenade
overflowing : Débordant
pulling out : sort
Figures : chiffres
Pain : douleur
waiver : renonciation
call on : faire appel / demander
call out : Crier
To participate in : Pour participer à
To take over : Pour prendre le relais 
a sharp : pointu
Tense : tendu
Shame : la honte
An argument : se disputer
summoned : convoqué
the counter : Le comptoir 
Rubber : caoutchouc
ropes : cordes
Formally : officiellement
Workshops : ateliers
upcoming : prochaine
Overdue : en retard
Oil spill : marée noir 
Happening : événement
Upset : contrarie
The track : la piste
bulk orders : Commandes en gros
Tight budget : Budget serré
Guilty : coupable
Brain : cerveau
Bustling with : animé avec 
As soon as : dès que 
Withholding : Retenue
to soak up : absorber
Plain-clothes : vêtement simple
compulsory : obligatoire
Faithful : fidèle
sticky : Collant
the grass : l’herbe
keyboard shortcut: Raccourci clavier
Dread : redouter
Caseload : charge de travail
Layover : escale
To dread : redouter
Spent : épuiser
Diary : journal intime
Out of order : hors service 
Turnover : chiffre d’affaire
go-ahead : le feu vert 
Tight : serré
Let : pas suivi de “to”
Overview : vue d’ensemble
Tireless : infaticable
undeterred : Résolument
decisiveness : Capacité à prendre des décisions
Devising : Conception
breath : souffle
Afford : permettre
Relevant : pertinent
my former colleagues : mes anciens collègues
Helpful : utile
Relevant : pertinent
Formally : officiellement
prior to then : Avant cela
At dawn : à l’aube
Behavior : comportement
Pain : douleur
Upset : contrarier
Relief : soulagement
Dress pants : pantalon habiller
Trails : sentiers
Dealership : concession
Realtor : agent immobilier
Noon : midi
Purses : sac a main
make an appointment : Prendre rendez-vous
Fold : plier
Thus : ainsi
brightly : brillamment (lumineux)
brilliantly : brillamment (competence)
Raw : crue
Shortfalls : Déficits
Sourcing : approvisionnement
Inquire : se renseigner
Hurry up : Depeche toi
Overseas : a l’étranger
Touch base : reprendre contact
Relate : raconter
Relevant : pertinent
Keen on : désireux de 
Useful : utile
Sworn : juré
I can hardly wait : Je ne peux pas attendre
Mandatory : obligatoire
sidetracked : détourné
Aimed : adresser
The bottom line : profit 
Recognition : reconnaissance
Steep : raide
Overdrawn : découvert
moving forward : allez de l’avant
Steam : vapeur
responsible for : responsable de
work things out : régler  les choses 
Oil spill : marais noir 
Cut down on : réduire sur 
Gives up : abandonner
Excepted : prévue 
Claims Adjuster : expert en sinistre
Relief : soulagement
